########
#  T##E#
#  ##  #   
#  #  ##
########
